#######
#.....#
#..P..#
#.....#
#######
!
P=PlayerCharacter.json
#=Wall.json
